Hi There
Change 1
Change 20:24
Change 20:49


SOURCE	nvarchar(MAX)	Checked
TIMESTAMP	datetime	Checked
HTTP_LINK	nvarchar(MAX)	Checked
PROPERTY_ADDRESS	nvarchar(MAX)	Checked
PROPERTY_TYPE_1	nvarchar(MAX)	Checked
PRODUCT_TYPE	nvarchar(MAX)	Checked
PRODUCT_AREA	float	Checked
PRODUCT_AREA_UNIT	nvarchar(MAX)	Checked
PRODUCT_AREA_TYPE	nvarchar(MAX)	Checked
DEVELOPER_NAME	nvarchar(MAX)	Checked
BUILDING_NAME	nvarchar(MAX)	Checked
PRICE	nvarchar(MAX)	Checked
RATE	float	Checked
RATE_UNIT	nvarchar(MAX)	Checked
LOCATION	nvarchar(MAX)	Checked
CITY	nvarchar(MAX)	Checked
PXVAL	float	Checked
PYVAL	float	Checked
OTHER_DETAILS	nvarchar(MAX)	Checked
ID	bigint	Unchecked
LF_PROJECT_ID	float	Checked
LF_CITY_ID	int	Checked
POSTED_SINCE	nvarchar(MAX)	Checked
OTHER_CHARGES	nvarchar(MAX)	Checked
DESCRIPTION	nvarchar(MAX)	Checked
RATE_PSF	float	Checked
PRODUCT_AREA_SQFT	float	Checked
NHB_CITY_ID	int	Checked
NHB_LOCALITY_ID	int	Checked
LF_LOCATION_ID	int	Checked
PROPERTY_TYPE_ID	int	Checked
CLEANING_STATUS	varchar(MAX)	Checked
R_GEOCODE_LOCALITY_PRED	varchar(255)	Checked
R_GEOCODE_SUBLOCALITY_PRED	varchar(255)	Checked
R_GEOCODE_LOCALITY_PRED_PROB	float	Checked
R_GEOCODE_SUBLOCALITY_PRED_PROB	float	Checked
GEOCODE_LEVEL_ID	int	Checked
GEOCODE_WORD_MATCHED	varchar(1000)	Checked
PXVAL_PRED	float	Checked
PYVAL_PRED	float	Checked
REGION_ID	int	Checked
SUB_REGION_ID	int	Checked
AREA_SIZE_TYPE_ID	int	Checked
PROPERTY_TYPE_2	nvarchar(MAX)	Checked
AREA_SIZE_TYPE_ID1	int	Checked
AGENT_NAME	varchar(256)	Checked
AGENT_TYPE	varchar(256)	Checked
BATH	int	Checked
BUILDING_AGE_MIN	int	Checked
BUILDING_AGE_MAX	int	Checked
BALCONY	int	Checked
CAR_PARKING	int	Checked
WASHROOM	int	Checked
PROPERTY_ON_FLOOR	int	Checked
TOTAL_FLOOR	int	Checked
DIMENSIONS	varchar(256)	Checked
FACING	varchar(256)	Checked
FACING_ROAD_WIDTH	float	Checked
FURNISHING	varchar(256)	Checked
READY_POSSESSION_BY	datetime	Checked
STATUS	varchar(256)	Checked
RERA_ID	nvarchar(4000)	Checked
PRODUCT_AREA_SQFT_CARPET	float	Checked
CARPET_RATE_PSF	float	Checked
PROPERTY_TYPE_1_ID	int	Checked
PROPERTY_TYPE_2_ID	int	Checked
CREATED_DATETIME	datetime	Checked
BUILDING_NAME_CLEANED	nvarchar(MAX)	Checked
NORM_BUILDING_NAME_CLEANED	nvarchar(MAX)	Checked
R_GEOCODE_ADDRESS_TEXT	nvarchar(MAX)	Checked
R_GEOCODE_ADDRESS_TEXT_CLEANED	nvarchar(MAX)	Checked
R_GEOCODE_ADDRESS_CATEGORY	nvarchar(MAX)	Checked
LOCATION_R_GEOCODE_ADDRESS_SIM	float	Checked
LOCATION_R_GEOCODE_ADDRESS_SIM_TYPE	varchar(255)	Checked
R_GEOCODE_CENTROID_PXVAL	float	Checked
R_GEOCODE_CENTROID_PYVAL	float	Checked
R_GEOCODE_RADIUS	float	Checked
R_GEOCODE_RECORD_COUNT	int	Checked
LOC_CLEANED_EXTRACTED_FROM_BLDG_NAME_CLEANED	nvarchar(MAX)	Checked
LF_PROJECT_ID_NEW	float	Checked
LF_PROPERTY_TYPE_1_ID	int	Checked
BUILDING_PROJECT_SIM	float	Checked
BUILDING_PROJECT_SIM_TYPE	varchar(255)	Checked
PRJ_DIST_FROM_R_GEOCODE_CENTROID	float	Checked
FINAL_PXVAL	float	Checked
FINAL_PYVAL	float	Checked
FINAL_RADIUS	float	Checked
BUILDING_ID	int	Checked
LOCATION_ID	int	Checked
